R 1620 1024
NO textures/wall_1.xpm
SO textures/wall_2.xpm
WE textures/wall_3.xpm
EA textures/wall_4.xpm
S textures/sprite_1.xpm
F 255,0,0
C 0,0,255

11111111111111111111111111111
10000000001100000000000000001
10110000011100000000000010001
10010000000000000000000010001
10110000011100000000000010001
10000000001100000111011110001
11110111111111011100000010001
11110111111111011101010010001
11000000110101011100000010001
10000000000000001100000010001
10000000000000001102010020001
11000000110101000000000000001
11110011110101000000202000001
10000000001100000100000010001
10000000000000002000000001001
10000000001000010000200001001
10000000001101000000N00000001
10000000000100000001010000001
11111111111111111111111111111
