R 1000 1000
NO textures/wall_1.xpm
SO textures/wall_2.xpm
WE textures/wall_3.xpm
EA textures/wall_4.xpm
S textures/sprite_1.xpm
SC textures/sprite_3.xpm
ST textures/sky_1.xpm
FT textures/floor_1.xpm

        1111111111111111111111111
        0000000000110000000000001
        1011000001110000002000001
        1001000000000000000000001
111111111011000001110000000000001
100000000011000001110111111111111
11110111111111011100000010001
11110111111111011101010010001
11000000110101011100000010401
10002000000000001100000010301
10000000000000001101010010201
11000001110101011111011110N01
11110111 1110101 101111010001
11111111 1111111 111111111111